╔═════════════════════════════════════════════════════════════════════════════════════════════════╦═══════╦═════════════════════════╗
║                                                                                                 ╨       ║                         ║
║                                                                                                         ║                         ║
║                                                                                                 ╥       ║                         ║
║                                       ╥                                                         ║       ║               ║         ║
║                                       ║                                                         ║       ║               ║         ║
║                                       ║                                                         ║       ║               ║         ║
║                              ╞════════╩═════════╡                                               ║       ║       ╞═══════╬═════════╣
║                                                                                                 ║       ║               ║         ║
║                                                                                                 ║       ║               ║         ║
║                                       ╥                                                         ║       ║               ║         ║
║                                       ║                                                         ║       ║               ║         ║
║                                       ║                                                         ║       ╨               ║         ║
╠═╡     ╞═══════════════════════════════╩═════════════════════════════════════════════════════════╝                       ║         ║
║                                                                                                                         ║         ║
║                                                                                                         ╥               ║         ║
╠════╡   ╞═══╗   ╔═════════════════════════════════════════════════════════╗                              ║               ║         ║
║            ║   ║                                                                          ╗   ╔         ║                         ║
║            ║   ╚════╗   ╔════════════════════════════════════════════════╝    ╔═══════════╝   ╚═════════╝                         ║
║            ╨        ╨   ╨                                                     ║                                                   ║
║                ╥                                                              ╨                                                   ║
║            ╥   ║                                                                                                                  ║
╚════════════╩═══╩══════════════════════════════════════════════════════════════════════════════════════════════════════════════════╝