╔══════════════════════════════════════════════════════════════════█══════════════════════════════╦═══════╦═════════════════════════╗·································································································································································································
║                                                                  █                              ╨       ║                         ║·································································································································································································
║   ╔══╡           ╥                              ╔══════════╡    ╞█                                      ║                         ║·································································································································································································
║   ║      ╔═══════╝                              ║                █       ██ ██ ██ ██ ██ ██      ╥       ║      ███      ╥    █    ║·································································································································································································
║   ╨      ║                            ╥         ╨                █                              ║       ║      ███      ║         ║·································································································································································································
║          ║  █████████                 ║                          █                              ║       ║               ║         ║·································································································································································································
║          ║  █       ██████            ║                                                         ║       ║               ║         ║·································································································································································································
║          ║  █            █   ╞════════╩═════════╡                █            ╞═════════════════╣       ║       ╞═══════╬═════════╣·································································································································································································
║          ║  █       ████ █                                       █                              ║       ║               ║         ║·································································································································································································
║          ║  █████████    █                            ██                                        ║       ║       ╥       ║         ║·································································································································································································
║          ║               █            ╥          ╞════██════╡    █                              ║       ║      ╞╬╡      ║█████████║·································································································································································································
║          ╨         ███████            ║               ██         █            ╞═════════════════╣       ║       ╨       ║         ║·································································································································································································
║                                       ║                          █                              ║       ╨               ║         ║·································································································································································································
╠═╡     ╞═══════════════════════════════╬══════════════════════════█══════════════════════════════╝                       ║         ║·································································································································································································
║                                       ║                          █                                        █     ╞═══════╬═════════╣·································································································································································································
║                 ╞═════╦═════╡         ╨                          ██████████████████████████████████████████             ║         ║·································································································································································································
║                       ║                                          █                                                      ║         ║·································································································································································································
║                       ║                                               ╔══╗                              ╥       ╥       ║    ╥    ║·································································································································································································
╠════╡   ╞══╗    ╔══════╩═══════════════════════════════════════════════╝  ╨                              ║      ╞╬╡      ║   ╞╬╡   ║·································································································································································································
║           ║    ║                                                                         ╞╗   ╔╡        ║       ╨       ╨    ╨    ║·································································································································································································
║           ╨    ╚════╗   ╔═════════════════════════════════════════════╗  ╥    ╔═══════════╝   ╠═════════╝                         ║·································································································································································································
║ ╥ ╥ ╥ ╥ ╥           ╨   ╨                                             ╚══╝    ║               ║                                   ║·································································································································································································
║ ╨ ╨ ╨ ╨ ╨      ╥           █                 █                  █             ╨  █            ╚════╡      ████████████████        ║·································································································································································································
║           ╥    ║                                                                                          █              █        ║·································································································································································································
║           ╚╗   ║                                                                      ╔══════════╗        █              █        ║·································································································································································································
║            ║   ║  █                 █                  █                █             ║          ║        █              █        ║·································································································································································································
║ ╞╡  ╞╡  ╞╡ ║   ╨                                                                      ║          ║        █                       ║·································································································································································································
║            ║                                                                          ║  ╥╥  ╥╥  ║        █              █        ║·································································································································································································
║            ║   ╥           █                 █                  █                █    ╚══╝╚══╝╚══╝        █              █        ║·································································································································································································
╚════════════╩═══╩══════════════════════════════════════════════════════════════════════════════════════════█══█══█══█══█╦╦█════════╝·································································································································································································
························································································································█╬╬█··········································································································································································································
························································································································█╬╬█··········································································································································································································
························································································································█╬╬█··········································································································································································································
························································································································█╬╬█·············································································································································································▄▄▄▄▄▄▄▄▄▄▄▄▄▄▄▄▄▄▄▄▄▄▄▄▄▄▄▄▄
························································································································█╬╬█·············································································································································································█                           █
························································································································█╬╬█·············································································································································································█                           █
························································································································█╬╬█·············································································································································································█                           █
························································································································█╬╬█·············································································································································································█                           █
························································································································█╬╬█·············································································································································································█                           █
························································································································█╬╬█·······································▄▄▄····························▄▄▄▄▄▄▄▄▄▄▄▄▄▄▄▄▄▄▄▄▄··················································································█                           █
························································································································█╬╬█·······································█ █····························█                   █···············································▄▄▄································█                           █
························································································································█╬╬█████████████████████████████████████████ ██████████████████████████████     ██████████    █████████████████████████████████████████████████ ██████████████████████████████████                           █
························································································································█╬╬╬╬╬╬╬╬╬╬╬╬╬╬╬╬╬╬╬╬╬╬╬╬╬╬╬╬╬╬╬╬╬╬╬╬╬╬╬╬╬╬╬                                                                                                                                         ▌                       █
························································································································██████████████████████████████████████████████████████████████████████████████████████████████████████████████████████████████████████████████████████████████████████████████████                           █
·········································································································································································································································································································█                           █
·········································································································································································································································································································█                           █
·········································································································································································································································································································█                           █
·········································································································································································································································································································▀▀▀▀▀▀▀▀▀▀▀▀▀▀▀▀▀▀▀▀▀▀▀▀▀▀▀▀▀