╔══════════════════════════════════════════════════════════════════█══════════════════════════════╦═══════╦═════════════════════════╗
║                                                                  █                              ╨       ║                         ║
║   ╔══╡           ╥                              ╔══════════╡    ╞█                                      ║                         ║
║   ║      ╔═══════╝                              ║                █       ██ ██ ██ ██ ██ ██      ╥       ║      ███      ╥    █    ║
║   ╨      ║                            ╥         ╨                █                              ║       ║      ███      ║         ║
║          ║  █████████                 ║                          █                              ║       ║               ║         ║
║          ║  █       ██████            ║                                                         ║       ║               ║         ║
║          ║  █            █   ╞════════╩═════════╡                █            ╞═════════════════╣       ║       ╞═══════╬═════════╣
║          ║  █       ████ █                                       █                              ║       ║               ║         ║
║          ║  █████████    █                            ██                                        ║       ║       ╥       ║         ║
║          ║               █            ╥          ╞════██════╡    █                              ║       ║      ╞╬╡      ║█████████║
║          ╨         ███████            ║               ██         █            ╞═════════════════╣       ║       ╨       ║         ║
║                                       ║                          █                              ║       ╨               ║         ║
╠═╡     ╞═══════════════════════════════╬══════════════════════════█══════════════════════════════╝                       ║         ║
║                                       ║                          █                                        █     ╞═══════╬═════════╣
║                 ╞═════╦═════╡         ╨                          ██████████████████████████████████████████             ║         ║
║                       ║                                          █                                                      ║         ║
║                       ║                                               ╔══╗                              ╥       ╥       ║    ╥    ║
╠════╡   ╞══╗    ╔══════╩═══════════════════════════════════════════════╝  ╨                              ║      ╞╬╡      ║   ╞╬╡   ║
║           ║    ║                                                                         ╞╗   ╔╡        ║       ╨       ╨    ╨    ║
║           ╨    ╚════╗   ╔═════════════════════════════════════════════╗  ╥    ╔═══════════╝   ╠═════════╝                         ║
║ ╥ ╥ ╥ ╥ ╥           ╨   ╨                                             ╚══╝    ║               ║                                   ║
║ ╨ ╨ ╨ ╨ ╨      ╥           █                 █                  █             ╨  █            ╚════╡      ████████████████        ║
║           ╥    ║                                                                                          █              █        ║
║           ╚╗   ║                                                                      ╔══════════╗        █              █        ║
║            ║   ║  █                 █                  █                █             ║          ║        █              █        ║
║ ╞╡  ╞╡  ╞╡ ║   ╨                                                                      ║          ║        █                       ║
║            ║                                                                          ║  ╥╥  ╥╥  ║        █              █        ║
║            ║   ╥           █                 █                  █                █    ╚══╝╚══╝╚══╝        █              █        ║
╚════════════╩═══╩══════════════════════════════════════════════════════════════════════════════════════════█══█══█══█══█══█════════╝